1  11 1  1  1  11 1  1  1  11 1  1  1  11 1  1  2  1  1  1  1  7  1  2  1  3  3  3  3  1  3  3  2  1  1  1  1  7  1  2  2  1  1  1  1  7  1  2  2  1  1  1  1  7  1  2  2  1  1  1  1  7  1  2  2  1  1  1  1  7  1  1  3  3  3  3  1  3  8  50
1  2  1  10 1  2  1  10 1  2  1  10 1  2  1  10 1  7  6  7  0  0  1  1  1  1  2  2  1  1  2  1  1  7  6  7  0  0  1  1  1  7  6  7  0  0  1  1  1  7  6  7  14 0  1  1  1  7  6  7  0  0  1  1  1  7  6  7  0  0  1  1  1  2  2  1  1  2  2  50
10 1  1  1  10 1  1  1  10 1  1  1  10 1  1  1  1  0  0  0  0  0  0  0  0  0  0  0  0  0  0  0  1  0  0  0  0  0  0  0  1  0  0  0  0  0  0  0  1  0  0  0  0  0  0  0  1  0  0  0  0  0  14 0  1  0  0  0  0  0  0  0  0  0  0  0  0  0  1  50
1  1  2  1  1  1  2  1  1  11 1  1  1  1  2  1  0  0  0  0  0  0  0  0  0  0  0  0  0  0  0  0  0  0  0  0  0  5  0  0  0  0  0  5  0  0  0  0  0  0  0  0  0  0  0  0  14 0  0  0  0  0  0  0  0  0  0  0  0  0  0  0  0  0  0  0  0  0  10 50
1  11 1  1  1  11 1  1  1  2  1  10 1  11 1  1  0  0  0  0  0  0  0  0  0  0  1  11 1  1  0  0  0  0  0  0  0  9  0  0  0  0  0  9  0  0  0  0  0  0  0  0  0  0  0  0  0  0  0  0  0  0  0  0  0  0  0  0  0  0  0  0  0  0  0  0  0  0  1  50
1  2  1  10 1  2  1  10 10 1  1  1  1  2  1  10 0  0  0  0  0  0  0  0  0  0  1  2  1  10 0  0  0  0  0  0  0  8  8  0  0  0  8  8  0  0  0  0  0  0  0  0  0  0  0  0  0  0  0  0  0  0  0  0  0  0  0  0  0  0  0  0  0  0  0  0  0  13 0  50
10 1  1  1  10 1  1  1  1  1  2  1  10 1  1  1  0  0  0  0  0  0  0  0  0  0  10 1  11 1  1  1  0  0  0  0  0  2  1  0  0  0  2  1  0  0  0  0  0  0  0  0  0  0  0  0  0  0  0  0  0  0  0  0  0  0  0  0  0  0  0  0  0  0  0  0  0  0  0  50
1  1  2  1  1  11 1  1  1  11 1  1  1  1  2  1  0  0  0  0  0  0  0  0  0  0  1  1  2  1  10 10 0  0  0  0  0  1  10 0  0  0  1  10 0  0  0  0  0  0  0  0  0  0  0  0  0  0  0  0  0  0  0  0  0  0  0  0  0  0  0  0  0  0  0  0  0  0  0  50
1  11 1  1  1  2  1  10 1  2  1  10 1  11 1  1  0  0  0  0  0  0  0  0  0  0  0  10 1  11 1  1  0  0  0  0  0  10 10 0  0  0  10 10 0  0  0  0  0  0  0  0  0  0  0  0  0  0  0  0  0  0  0  0  0  0  0  0  0  0  0  0  0  0  1  11 11 1  8  50
1  2  1  10 10 1  1  1  10 1  1  1  1  2  1  10 0  0  0  0  0  0  0  0  0  0  0  1  1  2  1  10 0  0  0  0  0  1  1  0  0  0  1  1  0  0  0  0  0  0  0  0  0  0  0  0  0  0  0  0  0  0  0  0  0  0  0  0  0  0  0  0  0  0  0  0  0  0  2  50
10 1  1  1  1  1  2  1  1  1  2  1  10 1  1  1  0  0  0  0  0  0  4  0  0  0  0  0  10 1  1  1  0  0  0  0  0  0  0  0  16 0  0  0  0  0  0  0  0  0  0  0  0  0  0  0  0  0  0  0  0  0  0  0  0  0  0  0  0  0  0  0  0  0  0  0  0  0  1  50
1  11 1  1  1  11 1  1  1  11 1  1  1  1  2  1  0  0  0  5  0  0  4  0  0  5  0  0  1  1  2  1  0  0  0  0  0  0  0  0  0  0  0  0  0  0  0  0  0  0  0  0  0  0  0  0  0  0  0  0  0  0  0  0  0  0  0  0  0  0  0  0  0  0  0  0  0  0  10 50
1  2  1  10 1  2  1  10 1  2  1  10 1  11 1  1  0  0  0  4  4  0  12 0  4  4  0  0  0  0  0  0  0  0  0  0  0  4  4  4  4  4  4  4  0  0  0  0  0  0  0  0  0  0  0  0  0  0  0  0  0  0  0  0  0  0  0  0  0  0  0  0  0  0  0  0  0  0  1  50
10 1  1  1  10 1  1  1  10 1  1  1  1  2  1  10 1  3  3  3  3  1  3  3  1  3  3  3  3  1  3  3  1  3  3  3  3  1  3  3  1  3  3  3  3  1  3  3  1  3  3  3  3  1  3  3  1  3  3  3  3  1  3  3  1  3  3  3  3  1  3  3  1  3  3  3  3  1  3  50
1  1  2  1  1  1  2  1  1  1  2  1  10 1  1  1  1  1  2  2  1  1  2  1  1  1  2  2  1  1  2  1  1  1  2  2  1  1  2  1  1  1  2  2  1  1  2  1  1  1  2  2  1  1  2  1  1  1  2  2  1  1  2  1  1  1  2  2  1  1  2  1  1  1  2  2  1  1  2  50